主演 是 成龙 大哥 呢	成龙
[2]成龙是著名香港影星，演技非常不错。	[2]成龙是著名香港影星，演技非常不错。
对，成龙还获得过香港电影金像奖的最佳男主角。	对，成龙还获得过香港电影金像奖的最佳男主角。
[3]我给你推荐一个可以当做记录片看的电影《龙的深处:失落的拼图 》	[3]我给你推荐一个可以当做记录片看的电影《龙的深处:失落的拼图 》
成龙哦。	成龙哦。
电影类型是纪录片传记类的，你去看看吧，值得一看	电影类型是纪录片传记类的，你去看看吧，值得一看
好的，拜拜	好的，拜拜
主唱是香港乐坛天王张国荣	主唱是香港乐坛天王张国荣
[2]谢谢夸奖，他可是全名偶像	[2]谢谢夸奖，他可是全名偶像
对的，还获得了香港电影金像奖金像奖最佳原创电影歌曲奖，很厉害呢。	对的，还获得了香港电影金像奖金像奖最佳原创电影歌曲奖，很厉害呢。
[3]是的，他的《沉默是金》是首很不错的歌	[3]是的，他的《沉默是金》是首很不错的歌
是的	是的
[4]需要为你播放吗	[4]需要为你播放吗
好的，不客气，正在为你播放	好的，不客气，正在为你播放
再见	再见
晚上20:00哦	晚上20:00哦
[2]对了，今天多云~阵雨, 无持续风向, 最高气温:15℃, 最低气温:4℃，记得晚上要关住窗户哦	[2]对了，今天多云~阵雨, 无持续风向, 最高气温:15℃, 最低气温:4℃，记得晚上要关住窗户哦
不客气哟，我应该的嘛	不客气哟，我应该的嘛
好的呢，拜拜	好的呢，拜拜
今天是2018年7月10日。	今天是2018年7月10日。
[2]你知道吗，今天也是张学友的生日啊。	[2]你知道吗，今天也是张学友的生日啊。
是啊，你喜欢张国荣吗？他是第32届印度国际电影节最佳男主角呢，很优秀。	是啊，你喜欢张国荣吗？他是第32届印度国际电影节最佳男主角呢，很优秀。
[3]给你推荐一首张国荣主唱的“她来听我的演唱会”，还不错哦。	[3]给你推荐一首张国荣主唱的“她来听我的演唱会”，还不错哦。
是啊，要不要在回忆一下？	是啊，要不要在回忆一下？
[4]那我现在为你播放“她来听我的演唱会”这首歌吗？	[4]那我现在为你播放“她来听我的演唱会”这首歌吗？
正在为你播放“她来听我的演唱会”。	正在为你播放“她来听我的演唱会”。
好的，再见。	好的，再见。
你好，张学友的生日是1961年7月10日。	你好，张学友的生日是1961年7月10日。
[2]谢谢。我还知道关于张学友的很多信息呢，需要讲给你听吗？	[2]谢谢。我还知道关于张学友的很多信息呢，需要讲给你听吗？
 好的，这就为您一一道来，曾获得十大中文金曲最高荣誉金针奖，第8届香港电影金像奖最佳男配角奖，金像奖最佳男主角、金马奖最佳男配角奖等等等等。	 好的，这就为您一一道来，曾获得十大中文金曲最高荣誉金针奖，第8届香港电影金像奖最佳男配角奖，金像奖最佳男主角、金马奖最佳男配角奖等等等等。
[3]最近还有关于他的新闻呢。9月30日，陕西咸阳"逃犯克星"张学友举行演唱会时再次"立功" 咸阳公安通报，不仅有5名逃犯落网，还抓获了其它违法犯罪人员13人 9月28日晚，张学友演唱会在石家庄举行时便成功抓获了3名逃犯 向娱乐圈卧底探员张Sir致敬！“逃犯克星”张学友又立功 5名逃犯在咸阳落网。	[3]最近还有关于他的新闻呢。9月30日，陕西咸阳"逃犯克星"张学友举行演唱会时再次"立功" 咸阳公安通报，不仅有5名逃犯落网，还抓获了其它违法犯罪人员13人 9月28日晚，张学友演唱会在石家庄举行时便成功抓获了3名逃犯 向娱乐圈卧底探员张Sir致敬！“逃犯克星”张学友又立功 5名逃犯在咸阳落网。
这样正说明了张学友的魅力真的很大啊。	这样正说明了张学友的魅力真的很大啊。
是呀，有这样的偶像真的很自豪啊。	是呀，有这样的偶像真的很自豪啊。
好的，再见。	好的，再见。
[1]莫娇玲女士，上午好，今天感觉如何？	[1]莫娇玲女士，上午好，今天感觉如何？
有什么困扰的事情么？	有什么困扰的事情么？
[2]那就给您推荐一部电影吧，《你是我的英雄》，城城年轻时少有的佳作。	[2]那就给您推荐一部电影吧，《你是我的英雄》，城城年轻时少有的佳作。
[3]那就聊聊《你是我的英雄》的主演吧。郭富城，您对他有什么了解么？	[3]那就聊聊《你是我的英雄》的主演吧。郭富城，您对他有什么了解么？
他是金马奖双料影帝， 创造吉尼斯纪录的明星。 	他是金马奖双料影帝， 创造吉尼斯纪录的明星。 
[4]为您推荐郭富城的新闻，谍战动作大片《密战》上映第一天口碑飘红。片中，郭富城 与赵丽颖 结成“革命夫妻”，进行“地下党”工作。高能打戏、智斗敌人的大场景炫酷画面，让人赞叹不已。郭富城饰演“特工”林翔的故事，是根据中国历史上真实的抗日英雄人物“李白”的故事改编。“李白”的真实经历到底有多传奇？戳→《密战》郭富城演的“特工”原型到底有多传奇。	[4]为您推荐郭富城的新闻，谍战动作大片《密战》上映第一天口碑飘红。片中，郭富城 与赵丽颖 结成“革命夫妻”，进行“地下党”工作。高能打戏、智斗敌人的大场景炫酷画面，让人赞叹不已。郭富城饰演“特工”林翔的故事，是根据中国历史上真实的抗日英雄人物“李白”的故事改编。“李白”的真实经历到底有多传奇？戳→《密战》郭富城演的“特工”原型到底有多传奇。
毕竟是金马奖双料影帝呢。	毕竟是金马奖双料影帝呢。
[5]希望这些新闻能对您有所帮助，祝您今天生活愉快。	[5]希望这些新闻能对您有所帮助，祝您今天生活愉快。
[1]郭凡华先生，晚上好啊！	[1]郭凡华先生，晚上好啊！
最近过的怎么样？	最近过的怎么样？
[2]开心的时候更适合看电影呢，看一下『分手大师』吧，还算不错的电影	[2]开心的时候更适合看电影呢，看一下『分手大师』吧，还算不错的电影
[3]这是杨幂主演的呢，她获得过华语电影传媒大奖观众票选最受瞩目女演员呢	[3]这是杨幂主演的呢，她获得过华语电影传媒大奖观众票选最受瞩目女演员呢
不过她的歌声也很美妙呢	不过她的歌声也很美妙呢
[4]听一下她的『爱的供养』吧，感受一下	[4]听一下她的『爱的供养』吧，感受一下
『一定要幸福』这首歌呢？这首歌您应该没听过，也一样好听呢	『一定要幸福』这首歌呢？这首歌您应该没听过，也一样好听呢
听完您就有所感受了	听完您就有所感受了
[5]需要现在播放吗？	[5]需要现在播放吗？
正在为您播放	正在为您播放
不客气呢，这都是我应该做的	不客气呢，这都是我应该做的
好的，下次再聊，再见	好的，下次再聊，再见
[1]早上好呀亲！	[1]早上好呀亲！
嗯，最近怎么样呢？	嗯，最近怎么样呢？
[2]是的呢，那亲，您尊姓大名呢？	[2]是的呢，那亲，您尊姓大名呢？
[3]嗯，是阿姨还是叔叔呢？	[3]嗯，是阿姨还是叔叔呢？
[4]那您今年多大啦？	[4]那您今年多大啦？
[5]嗯，确实有点老了，那您平时有啥爱好呢？	[5]嗯，确实有点老了，那您平时有啥爱好呢？
[6]好的，我知道了，再见！	[6]好的，我知道了，再见！
[1]下午好，莫凡宇同学，最近学习怎么样？	[1]下午好，莫凡宇同学，最近学习怎么样？
你真棒呀，继续加油哦	你真棒呀，继续加油哦
[2]聊了这么多，还不知道你叫什么名字呢？	[2]聊了这么多，还不知道你叫什么名字呢？
[3]你是男生还是女生呢？	[3]你是男生还是女生呢？
[4]你今年多大了呀？	[4]你今年多大了呀？
[5]你平时都有什么兴趣爱好？	[5]你平时都有什么兴趣爱好？
[6]下次再聊哦，再见	[6]下次再聊哦，再见
今天是2018年1月18号。	今天是2018年1月18号。
[2]你知道吗，今天也是周杰伦的生日呢。	[2]你知道吗，今天也是周杰伦的生日呢。
你眼光真好，周杰伦是大中华区8次年度唱片销量冠军，很优秀啊。	你眼光真好，周杰伦是大中华区8次年度唱片销量冠军，很优秀啊。
[3]给你推荐一首周杰伦主唱的“海盗”，还不错呢。	[3]给你推荐一首周杰伦主唱的“海盗”，还不错呢。
不光名字霸气，内容更丰富哦。	不光名字霸气，内容更丰富哦。
[4]现在是否为你播放“海盗”？	[4]现在是否为你播放“海盗”？
正在为你播放“海盗”。	正在为你播放“海盗”。
好的，再见。	好的，再见。
[1]胡玉振先生，您好，近期过的如何？	[1]胡玉振先生，您好，近期过的如何？
真的吗？那真是太恭喜你了，很厉害啊	真的吗？那真是太恭喜你了，很厉害啊
[2]正好有一条黄晓明的新闻：7日上午，黄晓明工作室发声明，称针对近日网络上的谣言，将用法律维护自己的权益。起因是有网友恶意截图、剪辑，称黄晓明说自己“除了幸福什么都有了”，还表示“心疼Angelababy”。而原采访并非如此	[2]正好有一条黄晓明的新闻：7日上午，黄晓明工作室发声明，称针对近日网络上的谣言，将用法律维护自己的权益。起因是有网友恶意截图、剪辑，称黄晓明说自己“除了幸福什么都有了”，还表示“心疼Angelababy”。而原采访并非如此
[3]说起黄晓明，他是亚洲电影大奖最佳男配角和大众电影百花奖_最佳男主角得主呢，是不是很优秀呢？	[3]说起黄晓明，他是亚洲电影大奖最佳男配角和大众电影百花奖_最佳男主角得主呢，是不是很优秀呢？
他还是第12届中国电影表演艺术学会金凤凰奖得主呢	他还是第12届中国电影表演艺术学会金凤凰奖得主呢
[4]特别好看的一部影片《暴疯语》推荐给你哦	[4]特别好看的一部影片《暴疯语》推荐给你哦
是一部惊悚剧情悬疑片哦	是一部惊悚剧情悬疑片哦
是的，有时间不妨看看呢	是的，有时间不妨看看呢
好嘞，再见	好嘞，再见
[1]你好啊	[1]你好啊
最近怎么样	最近怎么样
[2]那就放松放松，对了，你叫啥？	[2]那就放松放松，对了，你叫啥？
[3]听名字是位女士，对吗？	[3]听名字是位女士，对吗？
[4]冒昧的问一下你的年龄可以吗？	[4]冒昧的问一下你的年龄可以吗？
[5]辛苦了，你有啥爱好啊	[5]辛苦了，你有啥爱好啊
[6]不错，爱好挺多，那就不打扰你带孙子了，再见	[6]不错，爱好挺多，那就不打扰你带孙子了，再见
是王力宏哦。	是王力宏哦。
[2]不客气，他可是台湾偶像派歌手呢，你很喜欢他吗?	[2]不客气，他可是台湾偶像派歌手呢，你很喜欢他吗?
哈哈，很多人都喜欢他呢，还获得了MTV亚洲音乐台湾最受欢迎男歌手奖项呢。	哈哈，很多人都喜欢他呢，还获得了MTV亚洲音乐台湾最受欢迎男歌手奖项呢。
[3]支持你，那他演唱的『美』很好听，推荐你听听。	[3]支持你，那他演唱的『美』很好听，推荐你听听。
很好听的呢，超级受欢迎呢。	很好听的呢，超级受欢迎呢。
[4]那需要我为你播放吗？	[4]那需要我为你播放吗？
好的，已经为你播放，请你欣赏。	好的，已经为你播放，请你欣赏。
好的，路上注意安全。	好的，路上注意安全。
你好，今天是2018年10月18日。	你好，今天是2018年10月18日。
[2]不用谢，今天还是周迅的生日了哦，她是1974年10月18日出生于浙江衢州的。	[2]不用谢，今天还是周迅的生日了哦，她是1974年10月18日出生于浙江衢州的。
她的演技确实无可挑剔，获得过中国电影金鸡奖最佳女主角，大众电影百花奖最佳女主角这样的大奖呢。	她的演技确实无可挑剔，获得过中国电影金鸡奖最佳女主角，大众电影百花奖最佳女主角这样的大奖呢。
[3]她主演的《苏州河》挺不错的，推荐给你看一看。	[3]她主演的《苏州河》挺不错的，推荐给你看一看。
[4]那刘若英主演的《我们这一家》是一部轻松，好看的电影，你可以试着看一看。	[4]那刘若英主演的《我们这一家》是一部轻松，好看的电影，你可以试着看一看。
这部电影的主演除了刘若英还有古天乐这样的天王。	这部电影的主演除了刘若英还有古天乐这样的天王。
相信我，这部电影不会让你失望的。	相信我，这部电影不会让你失望的。
好的，晚安~	好的，晚安~
是张柏芝哦	是张柏芝哦
[2]是吗？真有眼光呢，她可是香港第一美女呢	[2]是吗？真有眼光呢，她可是香港第一美女呢
也很敬业呢，是个不畏拍戏受伤的演员哦	也很敬业呢，是个不畏拍戏受伤的演员哦
[3]那推荐你看看她演的『左右情缘』哦，很法式的一部短片，很优雅的哥哥～～张柏芝也清纯漂亮！	[3]那推荐你看看她演的『左右情缘』哦，很法式的一部短片，很优雅的哥哥～～张柏芝也清纯漂亮！
8.3哦，很高的	8.3哦，很高的
你会喜欢上的的。	你会喜欢上的的。
好的，拜拜！	好的，拜拜！
林志颖 是 天秤座 哦 。	林志颖
[2]那你喜欢他吗	[2]那你喜欢他吗
不错，他可是让人惊讶到无语的全能型选手	不错，他可是让人惊讶到无语的全能型选手
[3]嘻嘻，推荐你关于他的电影『恋爱大赢家』喜欢里面关于人鱼的对白	[3]嘻嘻，推荐你关于他的电影『恋爱大赢家』喜欢里面关于人鱼的对白
是林志颖 刘亦菲 许韶洋	是林志颖 刘亦菲 许韶洋
是啊，你会喜欢的呢	是啊，你会喜欢的呢
好的，那就再见啦	好的，那就再见啦
何炅的星座是金牛座，血型是A型哦。	何炅的星座是金牛座，血型是A型哦。
[2]过奖了嘿嘿，话说何炅获得过二十五届中国电视金鹰奖优秀主持人奖呢。	[2]过奖了嘿嘿，话说何炅获得过二十五届中国电视金鹰奖优秀主持人奖呢。
而且他也是“中国儿童慈善之星”哟。	而且他也是“中国儿童慈善之星”哟。
[3]而且他唱歌也很不错，他唱的这首『一路走过』你可以听听呢，是让人心情很好的一首歌。	[3]而且他唱歌也很不错，他唱的这首『一路走过』你可以听听呢，是让人心情很好的一首歌。
这首歌曲可是不容错过的呢。	这首歌曲可是不容错过的呢。
[4]那么现在需要为您播放这首歌来听听吗？	[4]那么现在需要为您播放这首歌来听听吗？
这就为您播放歌曲『一路走过』	这就为您播放歌曲『一路走过』
[5]嘿嘿，您喜欢就好，想聊天了随时再找我就好哦。	[5]嘿嘿，您喜欢就好，想聊天了随时再找我就好哦。
拜拜啦~	拜拜啦~
今天多云转晴, 西南风, 最高气温:14℃, 最低气温:3℃	今天多云转晴, 西南风, 最高气温:14℃, 最低气温:3℃
[2]为你服务我很开心，这种天气温适合吃糖醋排骨哦	[2]为你服务我很开心，这种天气温适合吃糖醋排骨哦
是道热菜	是道热菜
[3]推荐你去重庆万州烤鱼订糖醋排骨，特别棒	[3]推荐你去重庆万州烤鱼订糖醋排骨，特别棒
47	47
邗江区304县道（立祥超市斜对面）	邗江区304县道（立祥超市斜对面）
4.7 呢 ， 相当 高 了	4.7
好，现在就给你预定 	好，现在就给你预定 
再见啦	再见啦
[1]王立航又快到休息时间喽	[1]王立航又快到休息时间喽
那现在在干什么呢？	那现在在干什么呢？
[2]嗯呢，上次你说喜欢看电影，那最喜欢的电影是什么呢？	[2]嗯呢，上次你说喜欢看电影，那最喜欢的电影是什么呢？
[3]你最喜欢『遥远星球的孩子』里面哪个主演呢？	[3]你最喜欢『遥远星球的孩子』里面哪个主演呢？
[4]真不错呢，她的演技很棒，还曾获香港电影金紫荆奖最佳女主角呢	[4]真不错呢，她的演技很棒，还曾获香港电影金紫荆奖最佳女主角呢
嗯呢，这样的女人真的很别致	嗯呢，这样的女人真的很别致
[5]那要不要看看她演的『鸳鸯蝴蝶』？好看到爆呢	[5]那要不要看看她演的『鸳鸯蝴蝶』？好看到爆呢
那『巴尔扎克和小裁缝』呢？喜欢结尾的不想见，只怀念！	那『巴尔扎克和小裁缝』呢？喜欢结尾的不想见，只怀念！
评分还不错哦！7.4分呢	评分还不错哦！7.4分呢
[6]嗯呢，那先不打扰你了，下次聊	[6]嗯呢，那先不打扰你了，下次聊
成都，阴转晴, 西北风, 最高气温10度, 最低气温6度。	成都，阴转晴, 西北风, 最高气温10度, 最低气温6度。
[2]这样的天气来一份麻婆豆腐，岂不美哉。	[2]这样的天气来一份麻婆豆腐，岂不美哉。
麻婆豆腐主要成分，豆腐、鱿鱼、虾、香菇、洋葱、胡萝卜、小葱、蒜末、姜末、酱油、糖、辣椒面、香油、盐、胡椒粉、芝麻、清酒、淀粉。	麻婆豆腐主要成分，豆腐、鱿鱼、虾、香菇、洋葱、胡萝卜、小葱、蒜末、姜末、酱油、糖、辣椒面、香油、盐、胡椒粉、芝麻、清酒、淀粉。
[3]说到麻婆豆腐，三号院精致川菜这家店做的不错，而且还可以提前预定哦。	[3]说到麻婆豆腐，三号院精致川菜这家店做的不错，而且还可以提前预定哦。
人均消费价格是69	人均消费价格是69
这家店的评分是3.8	这家店的评分是3.8
地址在锦江区红星路三段1号IFS国际金融中心6楼616号（电影院旁）	地址在锦江区红星路三段1号IFS国际金融中心6楼616号（电影院旁）
已为您预定成功，祝您用餐愉快。	已为您预定成功，祝您用餐愉快。
好的，再见。	好的，再见。
他的身高是172cm。	他的身高是172cm。
[2]是啊，黄渤可是屌丝逆袭，我辈楷模。	[2]是啊，黄渤可是屌丝逆袭，我辈楷模。
嗯嗯，娱乐圈很优秀的男星了。	嗯嗯，娱乐圈很优秀的男星了。
[3]给你推荐一部他的电影《寻龙诀》，演的是一个一个精彩而夸张的盗墓故事。	[3]给你推荐一部他的电影《寻龙诀》，演的是一个一个精彩而夸张的盗墓故事。
他的类型是奇幻，冒险的剧情。	他的类型是奇幻，冒险的剧情。
口碑还好呢。	口碑还好呢。
好的，你一定会喜欢的。	好的，你一定会喜欢的。
好的，再见。	好的，再见。
[1]徐超舟先生你好啊！	[1]徐超舟先生你好啊！
最近过的怎么样？	最近过的怎么样？
[2]那恭喜啦，你什么喜欢的音乐吗？	[2]那恭喜啦，你什么喜欢的音乐吗？
[3]这首歌是周杰伦唱的，你喜欢听他的歌吗？	[3]这首歌是周杰伦唱的，你喜欢听他的歌吗？
周杰伦可是四届世界音乐大奖最畅销中华区艺人呢，他的歌就是好	周杰伦可是四届世界音乐大奖最畅销中华区艺人呢，他的歌就是好
[4]那你要不要听下他的『琴伤』呢？	[4]那你要不要听下他的『琴伤』呢？
那这首『你好吗』你一定会喜欢的	那这首『你好吗』你一定会喜欢的
是啊，您可以听一下绝对不会让您失望的。	是啊，您可以听一下绝对不会让您失望的。
[5]需要现在为您播放这首歌吗？	[5]需要现在为您播放这首歌吗？
正在为您播放『你好吗』	正在为您播放『你好吗』
是啊，周杰伦是不会让你失望的	是啊，周杰伦是不会让你失望的
好的，我就不打扰您了，再见。	好的，我就不打扰您了，再见。
无锡今天中雨~小雨, 东北风, 最高气温:17℃, 最低气温:12℃。	无锡今天中雨~小雨, 东北风, 最高气温:17℃, 最低气温:12℃。
[2]嘿嘿，过奖啦，像这种天气很适合听这首旋律不错的『时间煮雨 (live)』哦。	[2]嘿嘿，过奖啦，像这种天气很适合听这首旋律不错的『时间煮雨 (live)』哦。
是吴亦凡唱的呢。	是吴亦凡唱的呢。
[3]那么现在需要为您播放这首『时间煮雨 (live)』吗？	[3]那么现在需要为您播放这首『时间煮雨 (live)』吗？
好嘞，现在为您播放歌曲『时间煮雨 (live)』。	好嘞，现在为您播放歌曲『时间煮雨 (live)』。
好的呢，有缘再会。	好的呢，有缘再会。
当然知道，是周杰伦	当然知道，是周杰伦
[2]说到周杰伦，你觉得他是个怎样的人呢？	[2]说到周杰伦，你觉得他是个怎样的人呢？
他还是两届MTV亚洲大奖最受欢迎艺人，曾获两届台湾金曲奖最佳国语男歌手奖	他还是两届MTV亚洲大奖最受欢迎艺人，曾获两届台湾金曲奖最佳国语男歌手奖
[3]推荐你听听他唱的《屋顶》，很好听哦	[3]推荐你听听他唱的《屋顶》，很好听哦
有人听后感慨：黑夜崩溃的俗人，该怎么自救	有人听后感慨：黑夜崩溃的俗人，该怎么自救
[4]需要我为你播放吗？	[4]需要我为你播放吗？
正在为你播放，请欣赏	正在为你播放，请欣赏
好的，拜拜	好的，拜拜
吴亦凡身高187cm。	吴亦凡身高187cm。
[2]不客气，你问吴亦凡的信息是不是喜欢他呀？	[2]不客气，你问吴亦凡的信息是不是喜欢他呀？
是啊，他可是2015亚洲影响力东方盛典最具人气男神呢	是啊，他可是2015亚洲影响力东方盛典最具人气男神呢
[3]无所谓年龄，只要真心喜欢无所谓年龄与先来后到。这首吴亦凡演唱的『想你』您要不要听一下？	[3]无所谓年龄，只要真心喜欢无所谓年龄与先来后到。这首吴亦凡演唱的『想你』您要不要听一下？
那你一定要听一下了，这个歌非常好听的。	那你一定要听一下了，这个歌非常好听的。
[4]需要现在为您播放这首歌吗？	[4]需要现在为您播放这首歌吗？
正在为您播放『想你』	正在为您播放『想你』
不客气，您的喜欢就是对我最大的支持。	不客气，您的喜欢就是对我最大的支持。
好的，那我就不打扰您了，再见。	好的，那我就不打扰您了，再见。
[1]晚上好啊~	[1]晚上好啊~
最近过得怎么样？	最近过得怎么样？
[2]那真的恭喜你了。聊了这么长时间还不知道你叫什么呢。方便告诉一下吗？	[2]那真的恭喜你了。聊了这么长时间还不知道你叫什么呢。方便告诉一下吗？
[3]是个很文雅的名字呢，一听就能猜到是个大美女。	[3]是个很文雅的名字呢，一听就能猜到是个大美女。
[4]哈哈，看来被我猜对了。那冒昧的问下姑娘的芳龄？	[4]哈哈，看来被我猜对了。那冒昧的问下姑娘的芳龄？
[5]正值大好青春啊。平时都会有什么兴趣爱好呢？	[5]正值大好青春啊。平时都会有什么兴趣爱好呢？
[6]嗯嗯，我都记下了。那就不打扰你了，有时间我们再聊啊。	[6]嗯嗯，我都记下了。那就不打扰你了，有时间我们再聊啊。
[1]你好呀，刘萍露小姐姐。	[1]你好呀，刘萍露小姐姐。
看来你学习很好呀。	看来你学习很好呀。
[2]你一定要劳逸结合哦，你有听过《英雄之火+不灭火》这歌么，非常的好听。	[2]你一定要劳逸结合哦，你有听过《英雄之火+不灭火》这歌么，非常的好听。
[3]那你肯定会对他的主唱吴亦凡感兴趣的。他被称为国民偶像	[3]那你肯定会对他的主唱吴亦凡感兴趣的。他被称为国民偶像
吴亦凡不仅在演戏上获得认可，在时尚方面也是可圈可点哟，搜狐时尚盛典亚洲时尚偶像奖就是最好的证明。	吴亦凡不仅在演戏上获得认可，在时尚方面也是可圈可点哟，搜狐时尚盛典亚洲时尚偶像奖就是最好的证明。
[4]有一篇关于吴亦凡的新闻，你要看看么。	[4]有一篇关于吴亦凡的新闻，你要看看么。
好的，卓伟又放大招，吴亦凡绯闻风波再现新料！疑似吴亦凡与女子交谈视频曝光，他不仅吐槽北京雾霾、称自己是游戏高手，还让众女子叫自己“凡哥”。不知疑似女友“小g娜”现在心情作何。	好的，卓伟又放大招，吴亦凡绯闻风波再现新料！疑似吴亦凡与女子交谈视频曝光，他不仅吐槽北京雾霾、称自己是游戏高手，还让众女子叫自己“凡哥”。不知疑似女友“小g娜”现在心情作何。
[5]我下次再推荐其他的新闻给你哟，再见。	[5]我下次再推荐其他的新闻给你哟，再见。
[1]中午好柳琪琴，又到休息时间喽	[1]中午好柳琪琴，又到休息时间喽
最近怎么样？	最近怎么样？
[2]无聊的时候看看新闻吧，你最喜欢谁的新闻？	[2]无聊的时候看看新闻吧，你最喜欢谁的新闻？
[3]港媒报道，郭富城与方媛公开交往3个月以来，常送女方价值数千元的首饰、巧克力等礼物，方媛曾抱怨城城不肯送她10万元的爱马仕包，又传一直租房的方媛想在上海买房，看中两千万的豪宅，郭富城却老找借口拒陪方媛看房，有意藉此疏远女友。郭富城女友欲购上海两户豪宅	[3]港媒报道，郭富城与方媛公开交往3个月以来，常送女方价值数千元的首饰、巧克力等礼物，方媛曾抱怨城城不肯送她10万元的爱马仕包，又传一直租房的方媛想在上海买房，看中两千万的豪宅，郭富城却老找借口拒陪方媛看房，有意藉此疏远女友。郭富城女友欲购上海两户豪宅
谁知道呢	谁知道呢
做好自己就行了	做好自己就行了
[4]好啦，你先休息吧，不打扰你了，那咱们下次再聊吧	[4]好啦，你先休息吧，不打扰你了，那咱们下次再聊吧
知道啊，是王力宏	知道啊，是王力宏
[2]说起王力宏，你对他了解多少	[2]说起王力宏，你对他了解多少
不光如此，他还是全球流行音乐金榜年度最佳男歌手，曾获第15届华鼎奖全球最佳歌唱演员奖	不光如此，他还是全球流行音乐金榜年度最佳男歌手，曾获第15届华鼎奖全球最佳歌唱演员奖
[3]推荐你听听他唱的《不可能错过你》，很不错哦	[3]推荐你听听他唱的《不可能错过你》，很不错哦
有人说：我最早学会的一首力宏的歌，那时候的他还是一个大长腿爱跳很高的摇滚男孩子。	有人说：我最早学会的一首力宏的歌，那时候的他还是一个大长腿爱跳很高的摇滚男孩子。
[4]需要我为你播放吗？	[4]需要我为你播放吗？
正在为你播放，请欣赏	正在为你播放，请欣赏
好的，再见	好的，再见
[1]晚上好，牛娜君	[1]晚上好，牛娜君
忙什么呢？	忙什么呢？
[2]其实也可以看看电影来放松一下呢。『中国合伙人』这个电影很不错哦，内容丰富，不空洞	[2]其实也可以看看电影来放松一下呢。『中国合伙人』这个电影很不错哦，内容丰富，不空洞
[3]那你喜欢黄晓明吗？	[3]那你喜欢黄晓明吗？
黄晓明可是偶像派＋实力派呢	黄晓明可是偶像派＋实力派呢
[4]『欢乐颂 (Live)』这首歌很好听哦，推荐给你	[4]『欢乐颂 (Live)』这首歌很好听哦，推荐给你
『友情岁月』这首歌可是经典中的经典哦	『友情岁月』这首歌可是经典中的经典哦
主唱是黄晓明哦	主唱是黄晓明哦
[5]是否播放『友情岁月』？	[5]是否播放『友情岁月』？
没 问题 , 就 现在	播放
嗯 ， 再见	再见
[1]哈喽，任晓倩，最近还好吗？	[1]哈喽，任晓倩，最近还好吗？
这是什么事这么开心？	这是什么事这么开心？
[2]真为你感到高兴！那我给你推荐一部电影算是祝贺吧，黄晓明的『地球四季』，不错的影片哦！	[2]真为你感到高兴！那我给你推荐一部电影算是祝贺吧，黄晓明的『地球四季』，不错的影片哦！
[3]好吧，那我就陪你聊聊他的主演黄晓明吧，他可是个帅哥哦，演技日趋成熟！	[3]好吧，那我就陪你聊聊他的主演黄晓明吧，他可是个帅哥哦，演技日趋成熟！
确实很优秀呢，曾获得第10届中美电影节年度最佳男演员奖及第12届中国长春电影节最佳男主角，真是好棒啊！	确实很优秀呢，曾获得第10届中美电影节年度最佳男演员奖及第12届中国长春电影节最佳男主角，真是好棒啊！
[4]你这夸得好文艺呀，哈哈！我这里有条关于他的新闻推荐给你：近日，有港媒拍到angelababy抱着儿子小海绵返港的照片，并将小海绵正面照未打码曝光 15日黄晓明大怒，发博怒斥偷拍媒体不顾法律和道德底线，但随后秒删。原文如下 黄晓明斥港媒曝光儿子小海绵正面照	[4]你这夸得好文艺呀，哈哈！我这里有条关于他的新闻推荐给你：近日，有港媒拍到angelababy抱着儿子小海绵返港的照片，并将小海绵正面照未打码曝光 15日黄晓明大怒，发博怒斥偷拍媒体不顾法律和道德底线，但随后秒删。原文如下 黄晓明斥港媒曝光儿子小海绵正面照
是啊，作为父亲黄晓明真的好棒啊！	是啊，作为父亲黄晓明真的好棒啊！
一定会的，他这么优秀，也那么努力！	一定会的，他这么优秀，也那么努力！
好吧，那就再见啦！	好吧，那就再见啦！
好的，正在为你播放音乐“有一个地方 (live)”。	好的，正在为你播放音乐“有一个地方 (live)”。
[2]给你推荐一首吴亦凡的“刀剑如梦”，满满的小鲜肉风格，很不错呢，希望你喜欢。	[2]给你推荐一首吴亦凡的“刀剑如梦”，满满的小鲜肉风格，很不错呢，希望你喜欢。
那“November Rain”呢，也还不错。	那“November Rain”呢，也还不错。
是的。	是的。
[3]那现在为你播放吗？	[3]那现在为你播放吗？
歌曲“November Rain”正在为你播放。	歌曲“November Rain”正在为你播放。
好的，再见。	好的，再见。
现在时间2018年10月22日，晚上8点。	现在时间2018年10月22日，晚上8点。
[2]今天天气小雨, 东风, 最高气温:20℃, 最低气温:17℃。	[2]今天天气小雨, 东风, 最高气温:20℃, 最低气温:17℃。
[3]好的，那就不打扰您了，再见。	[3]好的，那就不打扰您了，再见。
好。	好。
有呀，没问题1月6日晚，霍建华工作室宣布林心如已经平安生下女儿的喜讯，并贴出一张女娃脚丫照。随后，林心如工作室转发微博: “世界美好，欢迎光临，我们的小公举！舒淇、赵薇、范冰冰、等送上祝福，恭喜！	有呀，没问题1月6日晚，霍建华工作室宣布林心如已经平安生下女儿的喜讯，并贴出一张女娃脚丫照。随后，林心如工作室转发微博: “世界美好，欢迎光临，我们的小公举！舒淇、赵薇、范冰冰、等送上祝福，恭喜！
[2]我这还有一篇你要看看么	[2]我这还有一篇你要看看么
好的，25日，北京市星权律师事务所发布案件简讯，称霍建华林心如联合起诉宋祖德名誉纠纷案二审胜诉。2017年5月，宋祖德曾发布《霍建华与林心如竟然没有领结婚证》一文。为维护自身权益，霍建华林心如将宋祖德起诉至北京市海淀区人民法院。法院一审后认为，该文侵害了霍建华林心如的名誉权。随后，宋祖德提出上诉。北京市第一中级人民法院经审理后判决: 驳回上诉，维持原判	好的，25日，北京市星权律师事务所发布案件简讯，称霍建华林心如联合起诉宋祖德名誉纠纷案二审胜诉。2017年5月，宋祖德曾发布《霍建华与林心如竟然没有领结婚证》一文。为维护自身权益，霍建华林心如将宋祖德起诉至北京市海淀区人民法院。法院一审后认为，该文侵害了霍建华林心如的名誉权。随后，宋祖德提出上诉。北京市第一中级人民法院经审理后判决: 驳回上诉，维持原判
对呀，这样的新闻还是少点吧	对呀，这样的新闻还是少点吧
好的，再见	好的，再见
今天多云, 西风, 最高气温:16℃, 最低气温:3℃，注意保暖哦。	今天多云, 西风, 最高气温:16℃, 最低气温:3℃，注意保暖哦。
[2]这种天气跟『梅菜扣肉』更配哦。	[2]这种天气跟『梅菜扣肉』更配哦。
由五花肉、梅干菜、八角、生抽、葱、白糖、老抽、姜、蜂蜜、鸡精、植物油、大枣组合而成一定很美味。	由五花肉、梅干菜、八角、生抽、葱、白糖、老抽、姜、蜂蜜、鸡精、植物油、大枣组合而成一定很美味。
[3]老七川菜馆的特色菜就是梅菜扣肉呢。	[3]老七川菜馆的特色菜就是梅菜扣肉呢。
平均每人32元左右。	平均每人32元左右。
地址在城北区祁连路914号金色家园银河鱼庄隔壁。	地址在城北区祁连路914号金色家园银河鱼庄隔壁。
评分是4.7分。	评分是4.7分。
好的，已经为你下单。	好的，已经为你下单。
再见。	再见。
[1]晚上好呀，何玲露女士。	[1]晚上好呀，何玲露女士。
嗯，在干啥呢？	嗯，在干啥呢？
[2]嗯，给您推荐一部《李小龙如何改变了世界》，很不错呢！李小龙就这样改变了世界！	[2]嗯，给您推荐一部《李小龙如何改变了世界》，很不错呢！李小龙就这样改变了世界！
[3]它的主演可是成龙哟，具老师范的明星，很了不起呢！	[3]它的主演可是成龙哟，具老师范的明星，很了不起呢！
是啊，他可是娱乐圈身价过亿明星富豪呢，很有钱的富二代！	是啊，他可是娱乐圈身价过亿明星富豪呢，很有钱的富二代！
[4]是呢，那为您推荐一首他唱的《我奋斗 我幸福》，感觉耳朵怀孕了！	[4]是呢，那为您推荐一首他唱的《我奋斗 我幸福》，感觉耳朵怀孕了！
那《醉拳(粤)》呢，素质不错的电影。	那《醉拳(粤)》呢，素质不错的电影。
[5]嗯，那现在为您播放下？	[5]嗯，那现在为您播放下？
已经为您播放了。	已经为您播放了。
[6]嗯，再见!	[6]嗯，再见!
今天是2018年12月27号。	今天是2018年12月27号。
[2]乌鲁木齐今天多云, 西北风, 最高气温:-13℃, 最低气温:-19℃，记得添衣。	[2]乌鲁木齐今天多云, 西北风, 最高气温:-13℃, 最低气温:-19℃，记得添衣。
不客气呢，这是我应该做的。	不客气呢，这是我应该做的。
好的，期待下次聊天再见。	好的，期待下次聊天再见。
[1]上午好啊，张芳姗。	[1]上午好啊，张芳姗。
最近学习怎么样啊？	最近学习怎么样啊？
[2]那就给你推荐一部『大赢家』是一部典型的喜剧哦，可以放松一下啦。	[2]那就给你推荐一部『大赢家』是一部典型的喜剧哦，可以放松一下啦。
[3]它里面的主演是林心如噢！	[3]它里面的主演是林心如噢！
是啊，而且她也是第50届台湾电视金钟奖最佳女主角提名奖得主呢!	是啊，而且她也是第50届台湾电视金钟奖最佳女主角提名奖得主呢!
[4]是啊，还有一首超级好听的《海洋》，你可以听听哦。	[4]是啊，还有一首超级好听的《海洋》，你可以听听哦。
每一个女孩子都喜欢认真又温柔的男孩子，一首《想着你》一定很适合你。	每一个女孩子都喜欢认真又温柔的男孩子，一首《想着你》一定很适合你。
那你听听看喽。	那你听听看喽。
[5]要不要我给你播放一下？	[5]要不要我给你播放一下？
正在播放	正在播放
好的，再见啦	好的，再见啦
好的主人，当然是大名鼎鼎的张国荣了！	好的主人，当然是大名鼎鼎的张国荣了！
[2]好的呢，他真的是一位优秀的演员，已经3次入围戛纳国际电影节最佳男演员奖呢！	[2]好的呢，他真的是一位优秀的演员，已经3次入围戛纳国际电影节最佳男演员奖呢！
是呢，您了解的还不少的吗，看来您是一位他的忠实粉丝呢！	是呢，您了解的还不少的吗，看来您是一位他的忠实粉丝呢！
[3]那这里有一首《怪你过份美丽》推荐给您，就是他唱的呢，很棒呢！	[3]那这里有一首《怪你过份美丽》推荐给您，就是他唱的呢，很棒呢！
是的呢，他唱的歌很受人欢迎呢，实力很强呢！	是的呢，他唱的歌很受人欢迎呢，实力很强呢！
[4]嘿嘿，那现在是否为您播放这首歌吗？	[4]嘿嘿，那现在是否为您播放这首歌吗？
已经为您播放了，请您好好欣赏！	已经为您播放了，请您好好欣赏！
好的呢，那拜拜了！	好的呢，那拜拜了！
[1]柳立彬中午好啊	[1]柳立彬中午好啊
最近怎么样啊	最近怎么样啊
[2]无聊就听首歌吧，这首『希望爱』你可以听听，幸福的意思是每个人用爱守护一辈子，愿我们心中永远都充满爱	[2]无聊就听首歌吧，这首『希望爱』你可以听听，幸福的意思是每个人用爱守护一辈子，愿我们心中永远都充满爱
[3]那你喜欢他的主唱何炅吗	[3]那你喜欢他的主唱何炅吗
是啊，没想到他这么瘦的人有这么大的张力！	是啊，没想到他这么瘦的人有这么大的张力！
[4]我这里有关于他的新闻，你要不要听听	[4]我这里有关于他的新闻，你要不要听听
是这样的，近日，何炅被举报在北京外国语大学吃空饷。今日北京外国语大学发声明称，2007年后对何炅的工作内容进行了调整，这期间何炅已将工资返还了学校，现何炅主动提出辞职，学校决定尊重何炅的选择。	是这样的，近日，何炅被举报在北京外国语大学吃空饷。今日北京外国语大学发声明称，2007年后对何炅的工作内容进行了调整，这期间何炅已将工资返还了学校，现何炅主动提出辞职，学校决定尊重何炅的选择。
是啊，你说的对	是啊，你说的对
好的，再见	好的，再见
[1]胡玉振你好，最近学习怎么样啊	[1]胡玉振你好，最近学习怎么样啊
要适当的缓解学习的压力哦，这样有助于提高的	要适当的缓解学习的压力哦，这样有助于提高的
[2]你最喜欢的歌曲名是什么呀？	[2]你最喜欢的歌曲名是什么呀？
[3]这首歌的主唱张国荣真的是风华绝代， 曾5次入围金马奖最佳男演员呢！	[3]这首歌的主唱张国荣真的是风华绝代， 曾5次入围金马奖最佳男演员呢！
而且他还是美国CNN亚洲最伟大25位演员之一，美国CNN全球五大指标音乐人，相当厉害呢	而且他还是美国CNN亚洲最伟大25位演员之一，美国CNN全球五大指标音乐人，相当厉害呢
[4] 『怪你过份美丽』这首歌好像就是一封情书，唱的我心动，推荐给你欣赏吧	[4] 『怪你过份美丽』这首歌好像就是一封情书，唱的我心动，推荐给你欣赏吧
『你这样恨我』这首歌那绝对值得你再次欣赏，哥哥温柔声线刚在耳边响起，整个世界都安静下来了。	『你这样恨我』这首歌那绝对值得你再次欣赏，哥哥温柔声线刚在耳边响起，整个世界都安静下来了。
我超级想见哥哥一面的，不知道你有没有这样的想法，真的遗憾	我超级想见哥哥一面的，不知道你有没有这样的想法，真的遗憾
[5]是否为您播放『你这样恨我』	[5]是否为您播放『你这样恨我』
正在为您播放『你这样恨我』	正在为您播放『你这样恨我』
[6]是不是快到学校了呀？今天也要加油哦！	[6]是不是快到学校了呀？今天也要加油哦！
2018年10月26日	2018年10月26日
[2]今天天气多云转晴, 西风, 最高气温:12℃, 最低气温:0℃	[2]今天天气多云转晴, 西风, 最高气温:12℃, 最低气温:0℃
嘻嘻嘻，能帮助到你我也很开心	嘻嘻嘻，能帮助到你我也很开心
拜拜	拜拜
好的，正在为你播放，请欣赏	好的，正在为你播放，请欣赏
[2]推荐你听听《天地》，也是吴亦凡唱的哦，有人说：吴亦凡，歌好听，人帅气，很有综艺感，期待他更多的作品，随时关注哦。	[2]推荐你听听《天地》，也是吴亦凡唱的哦，有人说：吴亦凡，歌好听，人帅气，很有综艺感，期待他更多的作品，随时关注哦。
那你可以听听他唱的《One Dream(Live)》，很不错哦	那你可以听听他唱的《One Dream(Live)》，很不错哦
有人评论：不得不感叹一下，现场的MV里面吴亦凡的颜值真的是神颜了，只是镜头不是很多	有人评论：不得不感叹一下，现场的MV里面吴亦凡的颜值真的是神颜了，只是镜头不是很多
[3]那是否需要我为你播放这首歌呢？	[3]那是否需要我为你播放这首歌呢？
正在为你播放，请欣赏	正在为你播放，请欣赏
好的，再见	好的，再见
好的，『近日，某富二代在北京举行婚礼请张柏芝参加，露面30分钟的酬劳是40万元人民币。张柏芝此举遭来一些网友的痛批，认为这对新人请来刚刚离婚的张柏芝前来参加婚礼，令人匪夷所思？』。	好的，『近日，某富二代在北京举行婚礼请张柏芝参加，露面30分钟的酬劳是40万元人民币。张柏芝此举遭来一些网友的痛批，认为这对新人请来刚刚离婚的张柏芝前来参加婚礼，令人匪夷所思？』。
[2]嗯嗯。是啊再给你推荐一个『在新片《危险关系》中章子怡与张柏芝算是杠上了，尽管章子怡是“女二”，但片酬高达9500万新台币。成为有史以来最贵的女二号。为和张柏芝别苗头，在记者会上章子怡更以性感低胸小礼服示人。在剧组，还耍脾气，闹失踪，让整个剧组傻等一整天。』。	[2]嗯嗯。是啊再给你推荐一个『在新片《危险关系》中章子怡与张柏芝算是杠上了，尽管章子怡是“女二”，但片酬高达9500万新台币。成为有史以来最贵的女二号。为和张柏芝别苗头，在记者会上章子怡更以性感低胸小礼服示人。在剧组，还耍脾气，闹失踪，让整个剧组傻等一整天。』。
人红是非多啊，一些恶人总是为了诋毁一个人有的说成没得。	人红是非多啊，一些恶人总是为了诋毁一个人有的说成没得。
嗯嗯，是的。	嗯嗯，是的。
再见。	再见。
当然知道，是吴亦凡	当然知道，是吴亦凡
[2]说起吴亦凡，你对他了解多少？	[2]说起吴亦凡，你对他了解多少？
不仅如此，他还是《时尚先生》年度先生(MAN AT HIS BEST 2014) 年度新人，曾获 “东京国际电影节·中国电影周”最佳男主角奖	不仅如此，他还是《时尚先生》年度先生(MAN AT HIS BEST 2014) 年度新人，曾获 “东京国际电影节·中国电影周”最佳男主角奖
[3]推荐你听听他唱的《制作人cypher (Live)》	[3]推荐你听听他唱的《制作人cypher (Live)》
好多人都喜欢听这首歌呢	好多人都喜欢听这首歌呢
[4]需要我为你播放吗？	[4]需要我为你播放吗？
正在为你播放，请欣赏	正在为你播放，请欣赏
那再见了	那再见了
[1]刘萍露小姐姐，中午好啊。	[1]刘萍露小姐姐，中午好啊。
最近的学习进步了没？	最近的学习进步了没？
[2]真的吗？太好了。顺便问下，你最喜欢谁的新闻啊？	[2]真的吗？太好了。顺便问下，你最喜欢谁的新闻啊？
[3]港媒报道，郭富城与方媛公开交往3个月以来，常送女方价值数千元的首饰、巧克力等礼物，方媛曾抱怨城城不肯送她10万元的爱马仕包，又传一直租房的方媛想在上海买房，看中两千万的豪宅，郭富城却老找借口拒陪方媛看房，有意藉此疏远女友。郭富城女友欲购上海两户豪宅。	[3]港媒报道，郭富城与方媛公开交往3个月以来，常送女方价值数千元的首饰、巧克力等礼物，方媛曾抱怨城城不肯送她10万元的爱马仕包，又传一直租房的方媛想在上海买房，看中两千万的豪宅，郭富城却老找借口拒陪方媛看房，有意藉此疏远女友。郭富城女友欲购上海两户豪宅。
是呀，希望他们能走下去吧。	是呀，希望他们能走下去吧。
[4]时间也不早了，快去吃饭吧，有空再聊啊。	[4]时间也不早了，快去吃饭吧，有空再聊啊。
有啊[近日，黄晓明在电影《无问东西》的发布会上，直面外界对angelababy的演技质疑，称她现在只是还没开窍 面对晓明哥这样“诚恳”的评价，baby在昨日接受采访时，给出了一个俏皮的回答 baby谈被黄晓明评价演技差]	有啊[近日，黄晓明在电影《无问东西》的发布会上，直面外界对angelababy的演技质疑，称她现在只是还没开窍 面对晓明哥这样“诚恳”的评价，baby在昨日接受采访时，给出了一个俏皮的回答 baby谈被黄晓明评价演技差]
[2]还有一个呢[昨日有网友曝出撞见黄晓明和Baby一同逛商场: 夫妇二人穿情侣装出街，虽都戴着帽子口罩，黄晓明还是霸道总裁范儿侧漏 身旁的Baby也是小鸟依人紧跟老公 看完二人逛的区域更是令网友大呼吃了OG级狗粮 ]	[2]还有一个呢[昨日有网友曝出撞见黄晓明和Baby一同逛商场: 夫妇二人穿情侣装出街，虽都戴着帽子口罩，黄晓明还是霸道总裁范儿侧漏 身旁的Baby也是小鸟依人紧跟老公 看完二人逛的区域更是令网友大呼吃了OG级狗粮 ]
是呢，很温馨，很美好	是呢，很温馨，很美好
一起期待吧	一起期待吧
那 就 再见 了	再见
你好，海口今天夜间到明天白天雷阵雨, 无持续风向, 最高气温:29℃, 最低气温:24℃。出门记得带伞啊。	你好，海口今天夜间到明天白天雷阵雨, 无持续风向, 最高气温:29℃, 最低气温:24℃。出门记得带伞啊。
[2]不用客气的，今天这个天气很适合听《中国魂 (Live)》这首歌了哟。	[2]不用客气的，今天这个天气很适合听《中国魂 (Live)》这首歌了哟。
这首歌是吴亦凡演唱的哦。	这首歌是吴亦凡演唱的哦。
[3]需要播放这首歌么？	[3]需要播放这首歌么？
现在为你播放《中国魂 (Live)》。	现在为你播放《中国魂 (Live)》。
那就不打扰你了，拜拜~	那就不打扰你了，拜拜~
它的主唱是周杰伦	它的主唱是周杰伦
[2]嘻嘻，你过奖啦！他是亚洲当红男星，你是他的粉丝吗？	[2]嘻嘻，你过奖啦！他是亚洲当红男星，你是他的粉丝吗？
看来你和我的品位相似呢！他是四届世界音乐大奖最畅销中华区艺人，令人敬佩！	看来你和我的品位相似呢！他是四届世界音乐大奖最畅销中华区艺人，令人敬佩！
[3]我也是的，一首我很喜欢的《路小雨》推荐你听下， 听这首曲子突然鸡皮疙瘩都起来了，很有感触！	[3]我也是的，一首我很喜欢的《路小雨》推荐你听下， 听这首曲子突然鸡皮疙瘩都起来了，很有感触！
是的，估计是你喜欢的风格	是的，估计是你喜欢的风格
[4]好的，需要为你播放吗？	[4]好的，需要为你播放吗？
收到，这就为你播放！希望你可以在音乐里有新的体会。	收到，这就为你播放！希望你可以在音乐里有新的体会。
那就让它伴你入睡吧，再见啦！	那就让它伴你入睡吧，再见啦！
[1]晚上好，最近学习怎么样？	[1]晚上好，最近学习怎么样？
你真棒呀，继续努力哦！	你真棒呀，继续努力哦！
[2]聊了这么多，还不知道你叫什么名字呢？	[2]聊了这么多，还不知道你叫什么名字呢？
[3]你是男生还是女生呢？	[3]你是男生还是女生呢？
[4]你今年多大了呀？	[4]你今年多大了呀？
[5]你平时都有什么兴趣爱好呢？	[5]你平时都有什么兴趣爱好呢？
[6]时间不早了，早点儿休息，再见。	[6]时间不早了，早点儿休息，再见。
好的额，正在播放	好的额，正在播放
[2]不客气，播放完毕，他的《Coupe》也不错哦，我想说，真的真的很好听，真的真的很棒	[2]不客气，播放完毕，他的《Coupe》也不错哦，我想说，真的真的很好听，真的真的很棒
那《刀剑如梦》呢？也很好听噢	那《刀剑如梦》呢？也很好听噢
很多人在听了	很多人在听了
[3]现在需要播放吗	[3]现在需要播放吗
好的，正在为你播放	好的，正在为你播放
好的，拜拜	好的，拜拜
今天是2018年4月28日	今天是2018年4月28日
[2]你知道吗？今天还是何炅的生日呢。	[2]你知道吗？今天还是何炅的生日呢。
何炅，湖南卫视当家主持人，中国大学生电视节最受大学生喜爱电视节目男主持人，“中国儿童慈善之星”	何炅，湖南卫视当家主持人，中国大学生电视节最受大学生喜爱电视节目男主持人，“中国儿童慈善之星”
[3]推荐你听听《现在爱》，这也是何老师的歌哦？	[3]推荐你听听《现在爱》，这也是何老师的歌哦？
网友说过我小学听的歌，终于找到了，十年了。	网友说过我小学听的歌，终于找到了，十年了。
[4]那现在为您播放《现在爱》如何？	[4]那现在为您播放《现在爱》如何？
真在为您播放，请欣赏	真在为您播放，请欣赏
好的，再见。	好的，再见。
好的，正在为你播放《汹涌》，请欣赏	好的，正在为你播放《汹涌》，请欣赏
[2]那你想听听同是何炅唱的另一首歌《我是大侦探》吗？	[2]那你想听听同是何炅唱的另一首歌《我是大侦探》吗？
那推荐你听一听《向前奔跑》，也是何炅唱的哦	那推荐你听一听《向前奔跑》，也是何炅唱的哦
有网友评论说，这首歌陪伴了他一整个高中，每天早上都是这个	有网友评论说，这首歌陪伴了他一整个高中，每天早上都是这个
[3]现在就可以为你播放，你要听吗？	[3]现在就可以为你播放，你要听吗？
正在为你播放《向前奔跑》，请欣赏	正在为你播放《向前奔跑》，请欣赏
好的，再见	好的，再见
是张国荣	是张国荣
[2]张国荣是去世后仍倍受喜爱的明星	[2]张国荣是去世后仍倍受喜爱的明星
而且他还是中国电影百年百位优秀演员之一	而且他还是中国电影百年百位优秀演员之一
[3]『你在何地』这首歌真的很棒，哥哥的歌真的太多经典了	[3]『你在何地』这首歌真的很棒，哥哥的歌真的太多经典了
虽然特逼好听，但是才排第47名！	虽然特逼好听，但是才排第47名！
[4]是否播放『你在何地』？	[4]是否播放『你在何地』？
正在播放『你在何地』	正在播放『你在何地』
那 就 再见 了	再见
[1]上午好，我的朋友，最近还好吗?	[1]上午好，我的朋友，最近还好吗?
要注意调整一下自己的工作状态哦，别永远那么累	要注意调整一下自己的工作状态哦，别永远那么累
[2]那就好，还不知道你的名字是？	[2]那就好，还不知道你的名字是？
[3]很好听的名字，是男的吧？	[3]很好听的名字，是男的吧？
[4]对对，那么多大年纪了呢？	[4]对对，那么多大年纪了呢？
[5]原来是位小哥哥啊，平时有什么爱好呢？	[5]原来是位小哥哥啊，平时有什么爱好呢？
爱好挺不错的，也要注意加强自身锻炼哦！	爱好挺不错的，也要注意加强自身锻炼哦！
嘿嘿，那好吧，下次记得找我哦，再见！	嘿嘿，那好吧，下次记得找我哦，再见！
5月12日是张柏芝和谢霆锋的小儿子谢振南（Quintus）的7岁生日。11日，谢霆锋携众亲友炮制家庭版“锋味”，为小儿子举行了一个温馨的家庭生日聚会 另一边，张柏芝完成工作立刻乘飞机回港为儿子庆祝生日 	5月12日是张柏芝和谢霆锋的小儿子谢振南（Quintus）的7岁生日。11日，谢霆锋携众亲友炮制家庭版“锋味”，为小儿子举行了一个温馨的家庭生日聚会 另一边，张柏芝完成工作立刻乘飞机回港为儿子庆祝生日 
是啊，让机器人非常羡慕呢	是啊，让机器人非常羡慕呢
[2]TVB《最佳男主角》专访谢霆锋，谢霆锋最后曝光一则隐私: 在拍《十月围城》时，因为剃了光头，被经纪人发现头上有颗黑色的瘤	[2]TVB《最佳男主角》专访谢霆锋，谢霆锋最后曝光一则隐私: 在拍《十月围城》时，因为剃了光头，被经纪人发现头上有颗黑色的瘤
不用担心，不影响他的帅气	不用担心，不影响他的帅气
看来你非常喜欢他呀	看来你非常喜欢他呀
嗯 嗯 。	拜拜
你好，今天是2018年11月13日。	你好，今天是2018年11月13日。
[2]今天还是国民男神黄晓明的生日了哦，他是1977年11月13日出生的。	[2]今天还是国民男神黄晓明的生日了哦，他是1977年11月13日出生的。
是呀，演技也是一流的，获得过第32届大众电影百花奖最佳男主角这样的大奖哦。	是呀，演技也是一流的，获得过第32届大众电影百花奖最佳男主角这样的大奖哦。
[3]他主演的《无问西东》挺不错的，推荐给你看一看。	[3]他主演的《无问西东》挺不错的，推荐给你看一看。
导演是李芳芳。	导演是李芳芳。
相信不会让你失望的。	相信不会让你失望的。
再见。	再见。
2018年4月28日	2018年4月28日
[2]你知道么今天是何炅的生日呢	[2]你知道么今天是何炅的生日呢
好的，第二十二; 《新周刊》最佳娱乐秀主持人; “中国儿童慈善之星	好的，第二十二; 《新周刊》最佳娱乐秀主持人; “中国儿童慈善之星
[3]给你推荐一首音乐《现在爱》我很爱你啊，很爱你的呀！初中听的歌，现在我大学了，继续来听	[3]给你推荐一首音乐《现在爱》我很爱你啊，很爱你的呀！初中听的歌，现在我大学了，继续来听
对呀	对呀
[4]是否为你播放	[4]是否为你播放
正在为你播放	正在为你播放
拜拜	拜拜
好的，今天重庆的天气是晴~多云, 东北风, 最高气温:12℃, 最低气温:5℃呢，还不错呢！	好的，今天重庆的天气是晴~多云, 东北风, 最高气温:12℃, 最低气温:5℃呢，还不错呢！
[2]这天气适合听《旧情绵绵》，很不错的一首歌呢！	[2]这天气适合听《旧情绵绵》，很不错的一首歌呢！
是的呢，很符合您现在的环境呢！	是的呢，很符合您现在的环境呢！
[3]那现在是否为您播放呢？	[3]那现在是否为您播放呢？
已经为您播放啦，请您好好欣赏吧！	已经为您播放啦，请您好好欣赏吧！
好的呢，那就不打扰您啦，再见！	好的呢，那就不打扰您啦，再见！
今天天气   晴~多云, 北风, 最高气温:16℃, 最低气温:-1℃，注意保暖哦。	今天天气   晴~多云, 北风, 最高气温:16℃, 最低气温:-1℃，注意保暖哦。
[2]这种天气适合吃『麻辣烫』。	[2]这种天气适合吃『麻辣烫』。
自制的呢。	自制的呢。
[3]可以在 『金权道韩式自助烤肉火锅』 订 『麻辣烫』。	[3]可以在 『金权道韩式自助烤肉火锅』 订 『麻辣烫』。
在44左右	在44左右
 大世界/时代中山中路大世界六楼	 大世界/时代中山中路大世界六楼
3.4，还算不错。	3.4，还算不错。
好的，马上为你预定。	好的，马上为你预定。
再见！	再见！
[1]刘萍露女士，中午好，今天的心情如何？	[1]刘萍露女士，中午好，今天的心情如何？
发生了什么事情么？	发生了什么事情么？
[2]心情不好的话,看个电影来转换下心情吧。『李小龙：勇士的旅程』感觉如何？追随勇者的旅程。	[2]心情不好的话,看个电影来转换下心情吧。『李小龙：勇士的旅程』感觉如何？追随勇者的旅程。
[3]这部电影的主演是极具影响力的亚洲影星成龙呢，有什么是想要知道的？	[3]这部电影的主演是极具影响力的亚洲影星成龙呢，有什么是想要知道的？
他拥有马来西亚拿督头衔; MTV电影大奖终身成就奖; 国家一级演员; 香港影坛天王级人物; 两届台湾电影金马奖最佳男主角。	他拥有马来西亚拿督头衔; MTV电影大奖终身成就奖; 国家一级演员; 香港影坛天王级人物; 两届台湾电影金马奖最佳男主角。
[4]他的歌也很不错哦。推荐给您一首他的『我奋斗 我幸福』吧。昨晚的你简直完美， 2019继续加油！	[4]他的歌也很不错哦。推荐给您一首他的『我奋斗 我幸福』吧。昨晚的你简直完美， 2019继续加油！
『醉拳(粤)』是否对您胃口？这些老大哥们有气势有人品就够受人喜欢受人热爱了，干嘛还要这些小鲜肉所谓的颜值。	『醉拳(粤)』是否对您胃口？这些老大哥们有气势有人品就够受人喜欢受人热爱了，干嘛还要这些小鲜肉所谓的颜值。
是一首非常好听的歌呢。	是一首非常好听的歌呢。
[5]需要我给你播放吗？	[5]需要我给你播放吗？
好的，已为您播放歌曲『醉拳(粤)』。	好的，已为您播放歌曲『醉拳(粤)』。
恩，有事的话找我。	恩，有事的话找我。
不对呦，他的星座是摩羯座哦	不对呦，他的星座是摩羯座哦
[2]嘿嘿，不知道关于周董你知道多少呢，我知道他可是2009年悉尼演唱会票房公告牌全球第二的厉害人物呢	[2]嘿嘿，不知道关于周董你知道多少呢，我知道他可是2009年悉尼演唱会票房公告牌全球第二的厉害人物呢
对啊，不愧是亚洲音乐天王	对啊，不愧是亚洲音乐天王
[3]不知道你听过这首『路小雨』吗？非常好听的呢	[3]不知道你听过这首『路小雨』吗？非常好听的呢
没错哦，你应该会喜欢的呢	没错哦，你应该会喜欢的呢
[4]那我现在给你播放吗？	[4]那我现在给你播放吗？
好嘞，正在播放	好嘞，正在播放
不客气，确实好听哈	不客气，确实好听哈
好的，拜拜	好的，拜拜
2018年9月12号	2018年9月12号
[2]你知道吗，今天还是杨幂的生日呢	[2]你知道吗，今天还是杨幂的生日呢
是啊，她还是娱圈工作狂明星呢	是啊，她还是娱圈工作狂明星呢
[3]推荐你看她的电影『消失的子弹』 很棒的电影，谢霆锋好帅，结局也很让我意外	[3]推荐你看她的电影『消失的子弹』 很棒的电影，谢霆锋好帅，结局也很让我意外
是 的 ， 真是 警察 的 好帮手 。	7
[4]好的，不打扰你了，下次聊吧	[4]好的，不打扰你了，下次聊吧
嗯，再见！	嗯，再见！
当然知道了，林心如是水瓶座的。	当然知道了，林心如是水瓶座的。
[2]说到林心如，她是两岸三地人气明星呢。	[2]说到林心如，她是两岸三地人气明星呢。
确实是的，林心如获得过第18届华鼎奖中国最佳电视剧女演员，第5届华鼎奖华语电影最佳女配角	确实是的，林心如获得过第18届华鼎奖中国最佳电视剧女演员，第5届华鼎奖华语电影最佳女配角
[3]推荐弄看看《倾城》，网友评论人的一生，都是在对与错、爱与恨、欢乐与痛苦中徘徊。	[3]推荐弄看看《倾城》，网友评论人的一生，都是在对与错、爱与恨、欢乐与痛苦中徘徊。
这是一部动作，剧情，犯罪类电影。	这是一部动作，剧情，犯罪类电影。
相信你不会失望的。	相信你不会失望的。
好的，再见。	好的，再见。
周杰伦身高175cm。	周杰伦身高175cm。
[2]不客气哦，你问周杰伦的信息是不是喜欢他呀？	[2]不客气哦，你问周杰伦的信息是不是喜欢他呀？
是啊，他可是两届MTV亚洲大奖最受欢迎艺人呢	是啊，他可是两届MTV亚洲大奖最受欢迎艺人呢
[3]周杰伦演唱的这首『不能说的秘密』是一首很好听的歌，您要不要听一下？	[3]周杰伦演唱的这首『不能说的秘密』是一首很好听的歌，您要不要听一下？
你可以听听试试，这首歌非常好听。	你可以听听试试，这首歌非常好听。
[4]需要现在为您播放这首歌吗？	[4]需要现在为您播放这首歌吗？
好的正在为您播放。	好的正在为您播放。
不客气，你喜欢就好。	不客气，你喜欢就好。
好的，我就不打扰你了，再见。	好的，我就不打扰你了，再见。
不对呦，他的星座是摩羯座哦	不对呦，他的星座是摩羯座哦
[2]嘿嘿，不知道关于周董你知道多少呢，我知道他可是2009年悉尼演唱会票房公告牌全球第二的厉害人物呢	[2]嘿嘿，不知道关于周董你知道多少呢，我知道他可是2009年悉尼演唱会票房公告牌全球第二的厉害人物呢
对啊，不愧是亚洲音乐天王	对啊，不愧是亚洲音乐天王
[3]不知道你听过这首『路小雨』吗？非常好听的呢	[3]不知道你听过这首『路小雨』吗？非常好听的呢
没错哦，你应该会喜欢的呢	没错哦，你应该会喜欢的呢
[4]那我现在给你播放吗？	[4]那我现在给你播放吗？
好嘞，正在播放	好嘞，正在播放
不客气，确实好听哈	不客气，确实好听哈
好的，拜拜	好的，拜拜
[1]杨晓娜，最近如何？	[1]杨晓娜，最近如何？
听起来你心情不错，有什么事值得开心吗？	听起来你心情不错，有什么事值得开心吗？
[2]那是挺值得高兴的，你平时喜欢看谁的新闻呢？	[2]那是挺值得高兴的，你平时喜欢看谁的新闻呢？
[3]最近听说范冰冰的新闻了吗？	[3]最近听说范冰冰的新闻了吗？
当然，在华中师范大学举行的导演冯小刚新片《我不是潘金莲》宣传活动出现小插曲，艺人范冰冰先是被堵在校门口一个小时，进场10分钟后又被要求马上离场否则将断电，冯小刚当场表示不满。同场参加活动的武汉籍作家方方还表示，“不敢相信这样的事发生在我所喜欢的华中师范大学”。今天上午，武汉市公安局官方微博回应舆情称“不背锅”，因为该活动不须公安机关审批，公安机关也未参与安保。据知情人士透露，现场的状况是安保的压力很大，校方怕范冰冰的人气高，在学校里面引发踩踏，所以要提前中止活动。	当然，在华中师范大学举行的导演冯小刚新片《我不是潘金莲》宣传活动出现小插曲，艺人范冰冰先是被堵在校门口一个小时，进场10分钟后又被要求马上离场否则将断电，冯小刚当场表示不满。同场参加活动的武汉籍作家方方还表示，“不敢相信这样的事发生在我所喜欢的华中师范大学”。今天上午，武汉市公安局官方微博回应舆情称“不背锅”，因为该活动不须公安机关审批，公安机关也未参与安保。据知情人士透露，现场的状况是安保的压力很大，校方怕范冰冰的人气高，在学校里面引发踩踏，所以要提前中止活动。
的确如此呢	的确如此呢
好的，再见	好的，再见
[1]嗨，金娜菲，又是新的一天啊	[1]嗨，金娜菲，又是新的一天啊
嗯，那你最近学习怎么样呢	嗯，那你最近学习怎么样呢
[2]那挺不错的呢，那我给你推荐一则周迅的新闻吧，《如懿传》第一集播出后，周迅因为“强行少女”上了热搜。周迅一直以来因其姣好的面容和灵动的眼神被称拥有一张“未婚妻脸”，但是在《如懿传》中却因为僵硬的轮廓和泛黄的眼白被群嘲丝毫没有少女感。“精灵”周迅是不是真的不适合演少女了？如懿传: 为什么周迅失去了少女感？	[2]那挺不错的呢，那我给你推荐一则周迅的新闻吧，《如懿传》第一集播出后，周迅因为“强行少女”上了热搜。周迅一直以来因其姣好的面容和灵动的眼神被称拥有一张“未婚妻脸”，但是在《如懿传》中却因为僵硬的轮廓和泛黄的眼白被群嘲丝毫没有少女感。“精灵”周迅是不是真的不适合演少女了？如懿传: 为什么周迅失去了少女感？
[3]好吧，那你想聊周迅吗	[3]好吧，那你想聊周迅吗
那你的眼光可真的好啊，别人评论他是中国影人中最爱的精灵天使呢	那你的眼光可真的好啊，别人评论他是中国影人中最爱的精灵天使呢
[4]嗯嗯，那我给你推荐一部记忆犹新的一部国产电影《桂林荣记》给你看看呢	[4]嗯嗯，那我给你推荐一部记忆犹新的一部国产电影《桂林荣记》给你看看呢
他的导演是谢衍	他的导演是谢衍
嗯嗯，真的值得你看看呢	嗯嗯，真的值得你看看呢
好的，拜拜	好的，拜拜
今天天气多云, 东北风, 最高气温:23℃, 最低气温:17℃	今天天气多云, 东北风, 最高气温:23℃, 最低气温:17℃
[2]今天这个天气适合吃[麻辣香锅]呢，这种凉爽的天气	[2]今天这个天气适合吃[麻辣香锅]呢，这种凉爽的天气
成分有这些呢，虾、菜花、包菜、鱼豆腐、火腿肠、蒜苗、油、豆瓣酱、黄豆酱、糖、味精、鸡精、生姜、蒜、香叶、花椒、辣椒、大料、料酒。	成分有这些呢，虾、菜花、包菜、鱼豆腐、火腿肠、蒜苗、油、豆瓣酱、黄豆酱、糖、味精、鸡精、生姜、蒜、香叶、花椒、辣椒、大料、料酒。
[3]推荐你一家[瑞余烤鱼堂·香锅·小炒（日韵东方店）]他家的特别好吃，也可以预定	[3]推荐你一家[瑞余烤鱼堂·香锅·小炒（日韵东方店）]他家的特别好吃，也可以预定
人均价格在46，评分4.4	人均价格在46，评分4.4
在长乐市中心城区鳌山路日韵东方沿街店面7至10号（东北门附近）	在长乐市中心城区鳌山路日韵东方沿街店面7至10号（东北门附近）
当然可以，马上为你预定	当然可以，马上为你预定
再见	再见
是杨幂哦。	是杨幂哦。
[2]看来你应该挺喜欢杨幂的吧，她可是中国电视金鹰奖最具人气女演员呢。	[2]看来你应该挺喜欢杨幂的吧，她可是中国电视金鹰奖最具人气女演员呢。
听说还是童星出身的明星呢。	听说还是童星出身的明星呢。
[3]给你推荐一个电影《北京童话》，据说是杨幂的第一部电影很唯美。	[3]给你推荐一个电影《北京童话》，据说是杨幂的第一部电影很唯美。
他是爱情剧情的哦。	他是爱情剧情的哦。
希望你喜欢呢。	希望你喜欢呢。
再见	再见
今天是2018年4月28日	今天是2018年4月28日
[2]今天还是何炅的生日呢	[2]今天还是何炅的生日呢
你喜欢他吗，他很厉害呢， 曾经获得过第三届中国影视网络影响力颁布盛最具网络影响力的十大电视主持人奖呢	你喜欢他吗，他很厉害呢， 曾经获得过第三届中国影视网络影响力颁布盛最具网络影响力的十大电视主持人奖呢
[3]要不要听一下『现在爱』这首歌啊，也许是何老师的主持人身份太过耀眼，让人不容易看见他的好歌曲	[3]要不要听一下『现在爱』这首歌啊，也许是何老师的主持人身份太过耀眼，让人不容易看见他的好歌曲
那你可以试一下，真的很好听。	那你可以试一下，真的很好听。
[4]现在要播放吗？	[4]现在要播放吗？
正在为您播放 『现在爱』	正在为您播放 『现在爱』
您的喜欢就是对我最大的鼓励	您的喜欢就是对我最大的鼓励
好的，期待下次再聊。	好的，期待下次再聊。
有呀，有这样一个新闻：在演艺圈，张国荣是性别与性倾向议题上的先锋光芒，他“出柜”的年代与环境，与现今谈论性少数的氛围极为不同。尽管如此，同性恋和双性恋者“出柜”，依然伴随着家庭压力，甚至遭遇社会隔离与同侪排挤。对于演艺圈艺人，出柜后丢掉工作、身价下滑的，不在少数。张国荣生前的磊落，烛照了他身后的娱乐圈，有更多性少数人士以公开身份施展拳脚。我们今日纪念张国荣最好的方式，依然是像他那样“做自己”。今日纪念张国荣，最好的方式是“做自己	有呀，有这样一个新闻：在演艺圈，张国荣是性别与性倾向议题上的先锋光芒，他“出柜”的年代与环境，与现今谈论性少数的氛围极为不同。尽管如此，同性恋和双性恋者“出柜”，依然伴随着家庭压力，甚至遭遇社会隔离与同侪排挤。对于演艺圈艺人，出柜后丢掉工作、身价下滑的，不在少数。张国荣生前的磊落，烛照了他身后的娱乐圈，有更多性少数人士以公开身份施展拳脚。我们今日纪念张国荣最好的方式，依然是像他那样“做自己”。今日纪念张国荣，最好的方式是“做自己
[2]根据你的兴趣，为你推荐另一条新闻：今天是哥哥张国荣去世十五周年，生前好友唐鹤德晒出一张月亮的照片，配文“知心唯有月”。张国荣生前曾以一首《月亮代表我的心》，向唐鹤德委婉表白，这月亮承载的东西，大概一直在唐生心里吧。	[2]根据你的兴趣，为你推荐另一条新闻：今天是哥哥张国荣去世十五周年，生前好友唐鹤德晒出一张月亮的照片，配文“知心唯有月”。张国荣生前曾以一首《月亮代表我的心》，向唐鹤德委婉表白，这月亮承载的东西，大概一直在唐生心里吧。
对呀，他们真是一对很好的伴侣呢	对呀，他们真是一对很好的伴侣呢
不客气，你喜欢就好呢	不客气，你喜欢就好呢
拜拜	拜拜
是金牛座哦。	是金牛座哦。
[2]你喜欢王力宏吗？	[2]你喜欢王力宏吗？
你真有眼光，王力宏是华语电影传媒大奖观众票选最受瞩目男演员呢。	你真有眼光，王力宏是华语电影传媒大奖观众票选最受瞩目男演员呢。
[3]给你推荐一则王力宏的新闻，日前，王力宏抵达机场遇到疯狂女粉丝，其大喊:“王力宏你是不是个男人，七年了你敢不敢说。”她被安保阻挡在隔离栏外，还推对方一把大喊“让开”，随后一路小跑追了出去 有粉丝说该女子曾在王力宏演唱会上丢过矿泉水瓶王力宏机场遇疯狂女粉丝 大喊“你是不是男人”。	[3]给你推荐一则王力宏的新闻，日前，王力宏抵达机场遇到疯狂女粉丝，其大喊:“王力宏你是不是个男人，七年了你敢不敢说。”她被安保阻挡在隔离栏外，还推对方一把大喊“让开”，随后一路小跑追了出去 有粉丝说该女子曾在王力宏演唱会上丢过矿泉水瓶王力宏机场遇疯狂女粉丝 大喊“你是不是男人”。
其实真正的原因是，这位女粉丝有臆想症，他以为王力宏是她老公，然后抛弃他了。	其实真正的原因是，这位女粉丝有臆想症，他以为王力宏是她老公，然后抛弃他了。
以后有什么问题可以直接来找我，我给你答疑。	以后有什么问题可以直接来找我，我给你答疑。
再见。	再见。
今天中雨转多云, 北风, 最高气温:19℃, 最低气温:15℃，天气还不错呢	今天中雨转多云, 北风, 最高气温:19℃, 最低气温:15℃，天气还不错呢
[2]这种天气适合去吃烤鱼呢！吃完之后特别舒服	[2]这种天气适合去吃烤鱼呢！吃完之后特别舒服
今天就可以去解解馋呢，天气也不错	今天就可以去解解馋呢，天气也不错
那祝你吃得开心	那祝你吃得开心
再见	再见
今天小雨, 东北风, 最高气温:13℃, 最低气温:7℃	今天小雨, 东北风, 最高气温:13℃, 最低气温:7℃
[2]不客气！今天的天气适合吃酸菜鱼呢！	[2]不客气！今天的天气适合吃酸菜鱼呢！
它的成分有龙利鱼、水、油豆皮、白萝卜、酸菜鱼调料、食用油。	它的成分有龙利鱼、水、油豆皮、白萝卜、酸菜鱼调料、食用油。
[3]那你看看湘雨轩新湘菜（首义汇店）这家店， 特色菜是酸菜鱼	[3]那你看看湘雨轩新湘菜（首义汇店）这家店， 特色菜是酸菜鱼
人均48	人均48
在武昌区张之洞路151号泛悦汇二楼北区A-L2-003	在武昌区张之洞路151号泛悦汇二楼北区A-L2-003
4.2分	4.2分
嗯嗯，马上为你安排！	嗯嗯，马上为你安排！
嗯嗯拜拜！	嗯嗯拜拜！
现在是2018年11月25日，晚上20:00哦。	现在是2018年11月25日，晚上20:00哦。
[2]这是应该的呢，天气方面你要了解一下吗？	[2]这是应该的呢，天气方面你要了解一下吗？
长沙今天多云~晴, 西北风, 最高气温:19℃, 最低气温:9℃。	长沙今天多云~晴, 西北风, 最高气温:19℃, 最低气温:9℃。
那是，随时待命哦。	那是，随时待命哦。
再见。	再见。
好的，2018年8月29日。	好的，2018年8月29日。
[2]你知道么，今天是谢霆锋的生日。	[2]你知道么，今天是谢霆锋的生日。
他可是非常厉害的一个明星哦，他也获得过不少奖呢，曾经获得过台湾电影金马奖的最佳男主角奖，还有香港电影金像奖的最佳原创电影歌曲奖。	他可是非常厉害的一个明星哦，他也获得过不少奖呢，曾经获得过台湾电影金马奖的最佳男主角奖，还有香港电影金像奖的最佳原创电影歌曲奖。
[3]我这有一篇关于谢霆锋的新闻要听听么？	[3]我这有一篇关于谢霆锋的新闻要听听么？
嗯，谢霆锋日前受邀录制小S的节目，首度回应恋情问题:不仅害羞承认私下会叫她“阿菲”；当被小S逼问“这一个礼拜之内你有跟别人接吻过吗”时，霆锋的回应也是令人意想不到 怎么突如其来就是一口狗粮？	嗯，谢霆锋日前受邀录制小S的节目，首度回应恋情问题:不仅害羞承认私下会叫她“阿菲”；当被小S逼问“这一个礼拜之内你有跟别人接吻过吗”时，霆锋的回应也是令人意想不到 怎么突如其来就是一口狗粮？
对呀，这就是在撒狗粮嘛。	对呀，这就是在撒狗粮嘛。
再见。	再见。
2018年1月18日	2018年1月18日
[2]谢谢夸奖哦，你知道吗，今天还是周杰伦的生日哦	[2]谢谢夸奖哦，你知道吗，今天还是周杰伦的生日哦
你眼光不错，他还入选美国CNN亚洲25位最具影响力人物了呢	你眼光不错，他还入选美国CNN亚洲25位最具影响力人物了呢
[3]他的歌《花海》不错啊，可以听听看	[3]他的歌《花海》不错啊，可以听听看
是的呢，你一定会喜欢的	是的呢，你一定会喜欢的
[4]那现在为你播放这首歌怎么样	[4]那现在为你播放这首歌怎么样
正在为你播放	正在为你播放
你喜欢就好啊	你喜欢就好啊
好的，拜拜	好的，拜拜
今天是2018年11月6日	今天是2018年11月6日
[2]你还不知道吧，今天同样是吴亦凡的生日呢	[2]你还不知道吧，今天同样是吴亦凡的生日呢
吴亦凡被评选为2015亚洲影响力东方盛典最具人气男神	吴亦凡被评选为2015亚洲影响力东方盛典最具人气男神
[3]要不要听一听吴亦凡的最新单曲『大碗宽面』呢？	[3]要不要听一听吴亦凡的最新单曲『大碗宽面』呢？
感觉有很多人喜欢的样子。	感觉有很多人喜欢的样子。
[4]是否需要为您播放『大碗宽面』呢？	[4]是否需要为您播放『大碗宽面』呢？
[5]让美妙的歌声陪您回家吧，再见！	[5]让美妙的歌声陪您回家吧，再见！
[1]你好呀	[1]你好呀
想和你交朋友，可以么？	想和你交朋友，可以么？
[2]你叫什么名字呢？	[2]你叫什么名字呢？
[3]这个名字真好听，你是女生还是男生呢？	[3]这个名字真好听，你是女生还是男生呢？
[4]你今天多大了呀	[4]你今天多大了呀
[5]你平常喜欢干嘛呢？	[5]你平常喜欢干嘛呢？
嗯嗯，爱好真广泛	嗯嗯，爱好真广泛
好的，拜拜	好的，拜拜
她是出生于我们中国的四川德阳中江哦	她是出生于我们中国的四川德阳中江哦
[2]确实也是，她还曾经拿过中国电视金鹰奖优秀主持人奖呢，非常厉害了	[2]确实也是，她还曾经拿过中国电视金鹰奖优秀主持人奖呢，非常厉害了
没错，非常直爽的性格也是圈了不少粉呢	没错，非常直爽的性格也是圈了不少粉呢
[3]有个关于她的事，你想听听吗？	[3]有个关于她的事，你想听听吗？
张杰谢娜这对新人选择在了云南的普达措公园举行他们的婚礼，而之前网上不断有传言称这场婚礼不仅斥3000万巨资完成，而且是由政府买单。而今日，作为西藏人代表的韩红挺身而出，为张杰谢娜辟谣。	张杰谢娜这对新人选择在了云南的普达措公园举行他们的婚礼，而之前网上不断有传言称这场婚礼不仅斥3000万巨资完成，而且是由政府买单。而今日，作为西藏人代表的韩红挺身而出，为张杰谢娜辟谣。
没错，不过这都是她的好人缘成就她的，能有几个这样的朋友也不错呢	没错，不过这都是她的好人缘成就她的，能有几个这样的朋友也不错呢
好的，拜拜	好的，拜拜
现在是北京时间2018年12月14日上午8:00	现在是北京时间2018年12月14日上午8:00
[2]今天南京的天气是晴~多云, 东北风, 最高气温:9℃, 最低气温:1℃，注意保暖哦！	[2]今天南京的天气是晴~多云, 东北风, 最高气温:9℃, 最低气温:1℃，注意保暖哦！
不客气，以后我还会为你持续推送天气的。	不客气，以后我还会为你持续推送天气的。
再见！	再见！
[1]中午好啊	[1]中午好啊
最近工作怎么样	最近工作怎么样
[2]那我和你聊聊天，你叫什么啊	[2]那我和你聊聊天，你叫什么啊
[3]那你是男士还是女士呢	[3]那你是男士还是女士呢
[4]那女士多大了	[4]那女士多大了
[5]那小姐姐平时有什么爱好	[5]那小姐姐平时有什么爱好
那挺不错的	那挺不错的
拜拜	拜拜
正在播放	正在播放
[2]推荐你听『迷魂曲』哦，不错的呢	[2]推荐你听『迷魂曲』哦，不错的呢
那就再推荐你听『骑士精神』非常棒的歌曲，你可以听听	那就再推荐你听『骑士精神』非常棒的歌曲，你可以听听
听的人挺多的呢	听的人挺多的呢
[3]是否播放	[3]是否播放
正在播放	正在播放
好的，再见	好的，再见
是O型哟	是O型哟
[2]客气，说起周迅，她获得过台湾电影金马奖最佳女主角哦	[2]客气，说起周迅，她获得过台湾电影金马奖最佳女主角哦
听说是个倔犟的人儿	听说是个倔犟的人儿
[3]她主演的一部现实折射理想的影片送给你，《如果·爱》	[3]她主演的一部现实折射理想的影片送给你，《如果·爱》
7.3的评分哦，不低呢	7.3的评分哦，不低呢
喜欢就好呢~	喜欢就好呢~
好的喔，再见	好的喔，再见
小王子的主演是『黄渤』哦。	小王子的主演是『黄渤』哦。
[2]也还好啦，说起黄渤他可是华语电影传媒大奖的观众票选最受瞩目男演员呢。	[2]也还好啦，说起黄渤他可是华语电影传媒大奖的观众票选最受瞩目男演员呢。
黄渤的身高是172cm，星座是处女座呢。	黄渤的身高是172cm，星座是处女座呢。
[3]那么黄渤出演的这部『人再囧途之泰囧』还蛮好笑蛮轻松的，推荐给你看看哦。	[3]那么黄渤出演的这部『人再囧途之泰囧』还蛮好笑蛮轻松的，推荐给你看看哦。
评分7.6还是不错的呢。	评分7.6还是不错的呢。
相信你会喜欢的。	相信你会喜欢的。
好的，再见啦。	好的，再见啦。
 多云~小雨, 东南风, 最高气温:16℃, 最低气温:2℃。	 多云~小雨, 东南风, 最高气温:16℃, 最低气温:2℃。
[2]你喜欢听音乐吗？这种天气适合听 『刀马旦』。	[2]你喜欢听音乐吗？这种天气适合听 『刀马旦』。
这是周杰伦演唱的，我觉得是很不错的一首歌。	这是周杰伦演唱的，我觉得是很不错的一首歌。
[3]那是否为你播放这首歌呢？	[3]那是否为你播放这首歌呢？
正在为你播放『刀马旦』。	正在为你播放『刀马旦』。
我猜你也一定会喜欢的。	我猜你也一定会喜欢的。
再见！	再见！
今天是2018年11月13日晚上22:00	今天是2018年11月13日晚上22:00
[2]而且还是黄晓明的生日呢，不过他是1977年出生的。	[2]而且还是黄晓明的生日呢，不过他是1977年出生的。
对的，比如第12届中国电影表演艺术学会金凤凰奖;以及第13届中国长春电影节最佳男主角等，都是他成功的证明。	对的，比如第12届中国电影表演艺术学会金凤凰奖;以及第13届中国长春电影节最佳男主角等，都是他成功的证明。
[3]你要不要看看《暴疯语》，这哥俩一定偷偷听了白云宋丹丹老师的演讲，病人好了，大夫疯了！	[3]你要不要看看《暴疯语》，这哥俩一定偷偷听了白云宋丹丹老师的演讲，病人好了，大夫疯了！
这是一部惊悚悬疑剧。	这是一部惊悚悬疑剧。
希望你会喜欢。	希望你会喜欢。
好的，再见！	好的，再见！
[1]晚上好啊，刘萍露，在干嘛呢？	[1]晚上好啊，刘萍露，在干嘛呢？
还是要找些事情排忧解闷哦。	还是要找些事情排忧解闷哦。
[2]那么聊聊新闻吧，你最喜欢关于谁的新闻啊？	[2]那么聊聊新闻吧，你最喜欢关于谁的新闻啊？
[3]是嘛，正好有他的新闻你要了解下吗？	[3]是嘛，正好有他的新闻你要了解下吗？
好的，这就为您推送『台湾歌手周杰伦今天被聘请成为“中国禁毒宣传形象大使”。周杰伦表示，他将以阳光健康的形象向广大青少年发出“拒绝毒品，拥有健康”的倡议，并承诺今后将积极宣传毒品危害，倡导全民珍爱生命，远离毒品。』	好的，这就为您推送『台湾歌手周杰伦今天被聘请成为“中国禁毒宣传形象大使”。周杰伦表示，他将以阳光健康的形象向广大青少年发出“拒绝毒品，拥有健康”的倡议，并承诺今后将积极宣传毒品危害，倡导全民珍爱生命，远离毒品。』
确实是，可以给很多人当榜样了。	确实是，可以给很多人当榜样了。
不客气哦，那我就不打扰你了。	不客气哦，那我就不打扰你了。
多云, 北风, 最高气温:3℃, 最低气温:-7℃	多云, 北风, 最高气温:3℃, 最低气温:-7℃
[2]这种天气适合吃 『重庆辣子鸡』	[2]这种天气适合吃 『重庆辣子鸡』
哈哈，这道菜很有名气的	哈哈，这道菜很有名气的
一定的~	一定的~
拜拜	拜拜
现在是晚上22:00啦	现在是晚上22:00啦
[2]我也喜欢你呢！温馨提示你长沙今天小雨, 西北风, 最高气温:13℃, 最低气温:9℃	[2]我也喜欢你呢！温馨提示你长沙今天小雨, 西北风, 最高气温:13℃, 最低气温:9℃
我不会离开你的，嘻嘻	我不会离开你的，嘻嘻
早点休息哦，再见！	早点休息哦，再见！
[1]杨凡杰同学，现在是晚上了，今天的心情还好么？	[1]杨凡杰同学，现在是晚上了，今天的心情还好么？
是学习上的事情么？	是学习上的事情么？
[2]心情不好的话看个新闻来调整一下吧。最喜欢谁的新闻？	[2]心情不好的话看个新闻来调整一下吧。最喜欢谁的新闻？
[3]正好为您推荐一篇他的新闻呢。何炅与家人的合照近日被曝光！照片中，何炅与何爸如同复制黏贴一般，样貌极为相似。哥哥何昊五官清秀俊朗，颜值丝毫不输小鲜肉，五官跟何炅相似，只是脸型有些不太一样。一家人聚在一起其乐融融，画面幸福温馨 何炅一家四口合照罕见曝光。	[3]正好为您推荐一篇他的新闻呢。何炅与家人的合照近日被曝光！照片中，何炅与何爸如同复制黏贴一般，样貌极为相似。哥哥何昊五官清秀俊朗，颜值丝毫不输小鲜肉，五官跟何炅相似，只是脸型有些不太一样。一家人聚在一起其乐融融，画面幸福温馨 何炅一家四口合照罕见曝光。
家人团聚是一件非常温馨的事情呢。	家人团聚是一件非常温馨的事情呢。
[4]恩。如果有什么事情的话记得找我，祝您能够开心，再见。	[4]恩。如果有什么事情的话记得找我，祝您能够开心，再见。
我知道，今天是2018年1月27日。	我知道，今天是2018年1月27日。
[2]这都是小事，对了，今天还是林心如的生日呢。	[2]这都是小事，对了，今天还是林心如的生日呢。
你眼光可真棒啊，她可是第18届华鼎奖中国最佳电视剧女演员呢。	你眼光可真棒啊，她可是第18届华鼎奖中国最佳电视剧女演员呢。
[3]是呢，她有一部拍的不错的电影《夜玫瑰》推荐给你看看呢。	[3]是呢，她有一部拍的不错的电影《夜玫瑰》推荐给你看看呢。
情节也挺不错的呢，你可以试着去看看呢，这部电影的导演是胡玥和吴思远。	情节也挺不错的呢，你可以试着去看看呢，这部电影的导演是胡玥和吴思远。
嗯嗯，好的。	嗯嗯，好的。
好的，拜拜。	好的，拜拜。
今天天气有点冷呢，多云转晴, 东北风, 最高气温:5℃, 最低气温:-3℃，注意保暖	今天天气有点冷呢，多云转晴, 东北风, 最高气温:5℃, 最低气温:-3℃，注意保暖
[2]这种天气很适合吃[水煮肉片]呢，特别棒	[2]这种天气很适合吃[水煮肉片]呢，特别棒
是热菜哦，冰冷的天气里，吃个这个真是太棒了	是热菜哦，冰冷的天气里，吃个这个真是太棒了
[3]推荐你一家餐馆『军城大酒店湘菜王』他家的就很不错呢，还可以预定	[3]推荐你一家餐馆『军城大酒店湘菜王』他家的就很不错呢，还可以预定
人均价格在36，评分有5呢	人均价格在36，评分有5呢
在经济开发区昌盛大街与307国道（龙泉东路）交叉口西南角	在经济开发区昌盛大街与307国道（龙泉东路）交叉口西南角
当然可以啦，马上为你预定	当然可以啦，马上为你预定
那 就 再见 了	再见
好的，今天是2018-11-18，下午18:00，星期日。	好的，今天是2018-11-18，下午18:00，星期日。
[2]不客气，今天天气晴, 无持续风向, 最高气温:11℃, 最低气温:-3℃，注意出门及时添加衣物哦。	[2]不客气，今天天气晴, 无持续风向, 最高气温:11℃, 最低气温:-3℃，注意出门及时添加衣物哦。
这是我应该的。	这是我应该的。
好的，再见。	好的，再见。
今天天气 晴, 西风, 最高气温:17℃, 最低气温:5℃。	今天天气 晴, 西风, 最高气温:17℃, 最低气温:5℃。
[2]这种天气很适合听一首歌，想要听一听吗？	[2]这种天气很适合听一首歌，想要听一听吗？
『中国魂 (Live)』，怎么样？	『中国魂 (Live)』，怎么样？
[3]那要不要给你放一下？	[3]那要不要给你放一下？
好的，正在为您播放『中国魂 (Live)』。	好的，正在为您播放『中国魂 (Live)』。
好的，再见。	好的，再见。
衡水今天有小雨, 北风, 最高气温:12℃, 最低气温:3℃，注意添衣哦。	衡水今天有小雨, 北风, 最高气温:12℃, 最低气温:3℃，注意添衣哦。
[2]嘻嘻，今天的天气适合听《你不在(Live)》，希望你会喜欢！	[2]嘻嘻，今天的天气适合听《你不在(Live)》，希望你会喜欢！
是王力宏唱的	是王力宏唱的
[3]现在为你播放吗？	[3]现在为你播放吗？
正在播放，稍等	正在播放，稍等
那就不打扰了，晚安,再见!	那就不打扰了，晚安,再见!
[1]你好啊刘萍露，吃午饭了吗？	[1]你好啊刘萍露，吃午饭了吗？
心情不好吗，饭不能不吃呀。	心情不好吗，饭不能不吃呀。
[2]没关系，以后努力，要不看看新闻来换换心情。哥哥的经纪人陈淑芬曾接到张国荣跳楼前的最后一个电话，那时张国荣打给她说:”你5分钟后在酒店门口等我，在正门，然后我就会来了。”在她赶到酒店后的5分钟听到轰然巨响……	[2]没关系，以后努力，要不看看新闻来换换心情。哥哥的经纪人陈淑芬曾接到张国荣跳楼前的最后一个电话，那时张国荣打给她说:”你5分钟后在酒店门口等我，在正门，然后我就会来了。”在她赶到酒店后的5分钟听到轰然巨响……
[3]你可以来了解一下张国荣哦，他是大明星， 也是很有爱心的人。	[3]你可以来了解一下张国荣哦，他是大明星， 也是很有爱心的人。
而且他演技了得，曾经主演电影《霸王别姬》荣获金棕榈大奖。	而且他演技了得，曾经主演电影《霸王别姬》荣获金棕榈大奖。
[4]不如给你推荐一首张国荣的《今生今世》，有人评论说高一的时候听着渣渣的音质，大一在KTV还唱着这首歌，记不得什么时候将这首歌尘封在记忆中，现在研二又莫名翻出这首歌……	[4]不如给你推荐一首张国荣的《今生今世》，有人评论说高一的时候听着渣渣的音质，大一在KTV还唱着这首歌，记不得什么时候将这首歌尘封在记忆中，现在研二又莫名翻出这首歌……
大概真的很多人喜欢这首歌呢。	大概真的很多人喜欢这首歌呢。
[5]那不如让我来为你播放这首《今生今世》？	[5]那不如让我来为你播放这首《今生今世》？
为你播放《今生今世》。	为你播放《今生今世》。
[6]你喜欢就好，下次继续聊。	[6]你喜欢就好，下次继续聊。
[1]你好啊，李明铮，最近怎么样呢？	[1]你好啊，李明铮，最近怎么样呢？
这是有什么好事吗？	这是有什么好事吗？
[2]那可真棒啊，你平时看新闻吗？你最喜欢谁的新闻呢？	[2]那可真棒啊，你平时看新闻吗？你最喜欢谁的新闻呢？
[3]你听说了吗？近日，江苏苏州，12月28日至30日张学友苏州演唱会再次上演“神助功”，三天时间里，苏州公安在全市范围内共抓获22名在逃人员。	[3]你听说了吗？近日，江苏苏州，12月28日至30日张学友苏州演唱会再次上演“神助功”，三天时间里，苏州公安在全市范围内共抓获22名在逃人员。
此前，苏州公安曾转发张学友演唱会苏州站预告，并称“懂了，懂了”。因此网友调侃道：公安战线著名歌手张学友要准备冲年度KPI了？	此前，苏州公安曾转发张学友演唱会苏州站预告，并称“懂了，懂了”。因此网友调侃道：公安战线著名歌手张学友要准备冲年度KPI了？
是啊	是啊
好的，再见	好的，再见
您好，今天全天晴转多云， 西南风, 最高气温:2℃, 最低气温:-7℃，气温略低，出门请注意保暖哦~	您好，今天全天晴转多云， 西南风, 最高气温:2℃, 最低气温:-7℃，气温略低，出门请注意保暖哦~
[2]谢谢您的夸奖~而且今天这个天气很适合去吃烤鱼呢。	[2]谢谢您的夸奖~而且今天这个天气很适合去吃烤鱼呢。
烤鱼属于热菜，对于这个寒冷的冬天来说，可以给您带来一丝丝的暖意哦。	烤鱼属于热菜，对于这个寒冷的冬天来说，可以给您带来一丝丝的暖意哦。
[3]如果您要吃烤鱼的话，我推荐您去『铭苑麻辣香锅-重庆烤鱼』这家店订餐，他们家的特色菜就是烤鱼呢。	[3]如果您要吃烤鱼的话，我推荐您去『铭苑麻辣香锅-重庆烤鱼』这家店订餐，他们家的特色菜就是烤鱼呢。
『铭苑麻辣香锅-重庆烤鱼』这家店的人均价格在44左右，绝对的物超所值，地址在宽城区青年路住邦城市广场四楼，您可以提前看一下距离远近哦，至于评分，这家店的评分在4.3，已经很高了，绝对会让您满意的。	『铭苑麻辣香锅-重庆烤鱼』这家店的人均价格在44左右，绝对的物超所值，地址在宽城区青年路住邦城市广场四楼，您可以提前看一下距离远近哦，至于评分，这家店的评分在4.3，已经很高了，绝对会让您满意的。
好的，我现在就给您预订。那家店有回复的话，我会第一时间给您说的。	好的，我现在就给您预订。那家店有回复的话，我会第一时间给您说的。
好的，您先去忙吧，再见~	好的，您先去忙吧，再见~
